Afghanistan	vlus-af1.pointtoserver.com
Albania	al1.pointtoserver.com
Algeria	vlus-dz1.pointtoserver.com
Angola	vlus-ao1.pointtoserver.com
Argentina	vlus-ar1.pointtoserver.com
Armenia	vleu-am1.pointtoserver.com
Aruba	aw1.pointtoserver.com
Australia	vlus-au1.pointtoserver.com
Australia	au-pe1.pointtoserver.com
Australia	au1.pointtoserver.com
Australia	au-bn.pointtoserver.com
Austria	at1.pointtoserver.com
Azerbaijan	az1.pointtoserver.com
Bahamas	bs1.pointtoserver.com
Bahrain	bh.pointtoserver.com
Bangladesh	vlus-bd1.pointtoserver.com
Barbados	vleu-bb.pointtoserver.com
Belgium	vleu-be1.pointtoserver.com
Belize	bz1.pointtoserver.com
Bermuda	vleu-bm.pointtoserver.com
Bolivia	vleu-bo.pointtoserver.com
Bosnia and Herzegovina	ba1.pointtoserver.com
Brazil	br1.pointtoserver.com
British_Virgin_Islands	vg1.pointtoserver.com
Brunei_Darussalam	bn1.pointtoserver.com
Bulgaria	bg1.pointtoserver.com
Cambodia	kh1.pointtoserver.com
Canada	cav1.pointtoserver.com
Canada	caq1.pointtoserver.com
Canada	cato.pointtoserver.com
Cape_Verde	vleu-cv.pointtoserver.com
Cayman_Islands	vleu-ky.pointtoserver.com
Chile	vlbr-cl1.pointtoserver.com
China	cn1.pointtoserver.com
China	cn-hn1.pointtoserver.com
Colombia	co1.pointtoserver.com
Costa_Rica	vlus-cr1.pointtoserver.com
Croatia	vlus-hr1.pointtoserver.com
Cuba	cu1.pointtoserver.com
Cyprus	cy1.pointtoserver.com
Czech_Republic	cz.pointtoserver.com
Denmark	vleu-dk1.pointtoserver.com
Dominica	vleu-dm.pointtoserver.com
Dominican_Republic	vleu-do.pointtoserver.com
Ecuador	ec1.pointtoserver.com
Egypt	vlus-eg1.pointtoserver.com
El_Salvador	vleu-sv.pointtoserver.com
Estonia_ee1.pointtoserver.com
Ethiopia	et1.pointtoserver.com
Finland	fi1.pointtoserver.com
France	fr1.pointtoserver.com
Georgia	vlus-ge1.pointtoserver.com
Germany	de1.pointtoserver.com
Germany	de-ao1.pointtoserver.com
Germany	
Germany	de1-sstp.pointtoserver.com
Ghana	gh1.pointtoserver.com
Greece	gr1.pointtoserver.com
Grenada	vleu-gd.pointtoserver.com
Guatemala	vleu-gt.pointtoserver.com
Guyana	vleu-gy.pointtoserver.com
Haiti	vls1360101.pointtoserver.com
Honduras	vleu-hn.pointtoserver.com
Hong_Kong (SAR)	hk1.pointtoserver.com
Hong_Kong (SAR)	hkf1.pointtoserver.com
Hungary	hu1.pointtoserver.com
Iceland	is1-sstp.pointtoserver.com
India	in1.pointtoserver.com
Indonesia	idn1.pointtoserver.com
Ireland	ie1.pointtoserver.com
Italy	it1.pointtoserver.com
Jamaica	jm1.pointtoserver.com
Japan	jp-tk1.pointtoserver.com
Jordan	vlus-jo1.pointtoserver.com
Kazakhstan	vlus-kz1.pointtoserver.com
Kenya	ke1.pointtoserver.com
Korea, South	kr1.pointtoserver.com
Kuwait	vlus-kw1.pointtoserver.com
Kyrgyzstan	vlus-kg1.pointtoserver.com
Laos	vlus-la1.pointtoserver.com
Latvia	lv1.pointtoserver.com
Lebanon	lb1.pointtoserver.com
Liechtenstein	li1.pointtoserver.com
Lithuania	lt1.pointtoserver.com
Luxembourg	lu1.pointtoserver.com
Macao	mo1.pointtoserver.com
Madagascar	vlus-mg1.pointtoserver.com
Malaysia	my-kl1.pointtoserver.com
Malaysia	my1.pointtoserver.com
Malta	mt1.pointtoserver.com
Mauritania	vlus-mr1.pointtoserver.com
Mauritius	mu1.pointtoserver.com
Mexico	vlus-mx1.pointtoserver.com
Moldova	md1.pointtoserver.com
Monaco	mn1.pointtoserver.com
Mongolia	vlus-mn1.pointtoserver.com
Montserrat	vleu-ms.pointtoserver.com
Morocco	ma1.pointtoserver.com
Netherlands	nl1.pointtoserver.com
New_Zealand	nz.pointtoserver.com
Nicaragua	vleu-ni.pointtoserver.com
Niger	vlus-ne1.pointtoserver.com
Nigeria	ng1.pointtoserver.com
Norway	vleu-no1.pointtoserver.com
Oman	om1.pointtoserver.com
Pakistan	pk1.pointtoserver.com
Panama	vlus-pa1.pointtoserver.com
Papua_New_Guinea	vlus-pg1.pointtoserver.com
Paraguay	vleu-py.pointtoserver.com
Peru	pe1.pointtoserver.com
Philippines	vlap-ph1.pointtoserver.com
Poland	pl1.pointtoserver.com
Portugal	pt1.pointtoserver.com
Puerto Rico	pr1.pointtoserver.com
Qatar	qa1.pointtoserver.com
Romania	ro1.pointtoserver.com
Russia	ru1.pointtoserver.com
Saint_Lucia	vleu-lc.pointtoserver.com
Saudi_Arabia	sa1.pointtoserver.com
Senegal	vlus-sn1.pointtoserver.com
Seychelles	sc1.pointtoserver.com
Singapore	sg1.pointtoserver.com.
Slovakia	sk1.pointtoserver.com
Slovenia	si1.pointtoserver.com
South_Africa	za1.pointtoserver.com
Spain	es1.pointtoserver.com
Sri_Lanka	vlus-lk1.pointtoserver.com
Suriname	vleu-sr.pointtoserver.com
Sweden	se1.pointtoserver.com
Switzerland	ch1.pointtoserver.com
Syria	sy1.pointtoserver.com
Taiwan	vlap-tw1.pointtoserver.com
Tajikistan	vlus-tj1.pointtoserver.com
Tanzania	vlus-tz1.pointtoserver.com
Thailand	vlap-th1.pointtoserver.com
Trinidad and Tobago	vleu-tt.pointtoserver.com
Tunisia	vlus-tn1.pointtoserver.com
Turkey	tr1.pointtoserver.com
Turkmenistan	vlus-tm1.pointtoserver.com
Turks_and_Caicos_Islands	vleu-tc.pointtoserver.com
Ukraine	ua1.pointtoserver.com
United_Arab_Emirates	ae1.pointtoserver.com
United_Kingdom	vlap-ukle.pointtoserver.com
United_Kingdom	vlus-uk-man1.pointtoserver.com
United_Kingdom	ukl-sstp.pointtoserver.com
United_Kingdom	ukm1.pointtoserver.com
United_Kingdom	ukg1.pointtoserver.com
United_States	usfl1.pointtoserver.com
United_States	vleu-usoh1.pointtoserver.com
United_States	sstp-wdc.pointtoserver.com
United_States	ussf.pointtoserver.com
United_States	usla1.pointtoserver.com
United_States	ny1-sstp.pointtoserver.com
United_States	usphx1.pointtoserver.com
United_States	usva.pointtoserver.com
United_States	usut.pointtoserver.com
United_States	usnj1.pointtoserver.com
United_States	usga1.pointtoserver.com
United_States	usil1.pointtoserver.com
United_States	ussa.pointtoserver.com
United_States	sstp-tx.pointtoserver.com
Uzbekistan	vlus-uz1.pointtoserver.com
Venezuela	ve1.pointtoserver.com
Vietnam	vlap-vn1.pointtoserver.com
Yemen	ym1.pointtoserver.com
Serbia	rs1.pointtoserver.com
Montenegro	me1-sstp.pointtoserver.com
Isle_of_Man	im1.pointtoserver.com
Myanmar	vlus-mm1.pointtoserver.com
